##############################
#S NNNNNNNNNNNNNNNNNNNNNNNN G#
# ########################## #
#                            #
#                            #
#                            #
#                            #
#                            #
#                            #
##############################