##############################
#S                        # G#
# ########################  ##
#    #                     # #
# ###### ################### #
# #                        # #
# # ######################## #
#                            #
##############################